11111111111111111111111111111111111111111
100000000000000000000000000000000000000C1
10000000000000111111100111111111111110001
1000000000011111111C000111100011111110001
1000000001111111PC000001000C0011111110001
10000011111111E0000000000000001111111C001
10001111111C00000000000000011111111000001
100111111C0000000000000001111111100000001
100111100000000CC000000111111100000000001
10011111111111111111100111111100000010001
10011111111111111111100111111100011110001
10000000000000111111100111111111111110001
1000C000000000111111100000000000000000001
100000000000C0111111100000000C000000000C1
11111111111110000000000000001111111111111
11111111111111111111111111111111111111111