1111111111111111111111111111111111111111
10000000000000000000000000000000000000C1
1000000000000011111110011111111111111001
1000000000011111111C00011110001111111001
1000000001111111PC000001000C001111111001
10000011111111E0000000000000001111111C01
10001111111C0000000000000001111111100001
100111111C000000000000000111111110000001
100111100000000CC00000011111110000000001
1001111111111111111110011111110000001001
1001111111111111111110011111110001111001
1000000000000011111110011111111111111001
1000C00000000011111110000000000000000001
100000000000C0111111100000000C00000000C1
1111111111111000000000000000111111111111
1111111111111111111111111111111111111111